15
20
PTTTWWWPPTPWTLLTPWLT
PLLMLWLPPTPWTLLTPWLT
PLLTLLLLPTPWTLLTPWLT
PPPPWLLTPTPWTLLTPWLT
TTTPPPWTPTPWTLLTPWLT
TTTPPPWTPTPWTLLTPWLT
TTTPPPWTPPPPPLLMMMLT
TTTPPPWTPTPWTLLPPPLT
TTTPPPWTPTPWTLLLLLLT
TTTPPPWTPTPWTLLLLLLT
TTTPPPWTPTPWTLLTPWLT
TTTPPPMTPTPWTLLTPWLT
TTTPPPMTPTPWTLLTPWLT
TTTPPPMTPTPWTLLTPWLT
TTTPPPLLPTPWTLLTPWLL
