5
8
PTTTWWWP
PLLMLWLP
PLLTLLLL
PPPPWLLT
TTTPPPWT
